Comandos do Cookiebot!

qualquercoisa - Uma foto doq vc quiser
ideiadesenho - Chega de art block
everyone - Admins podem chamar todos os membros do grupo
regras - Mostra as regras do grupo
novasregras - Atualiza as regras do grupo
novobemvindo - Atualiza a mensagem de boas vindas
portugues - Traduz texto para pr/br
ingles - Traduz texto para us/en
hoje - DESATIVADO COM O BURRBOT
cheiro - DESATIVADO COM O BURRBOT
eventos - Proximos eventos registrados em mim
addevento - Criar um evento
removeevento - Deletar um evento
startup - Qual o slogan da sua startup
numero - Falo fatos sobre um numero
insulto - Mando a real
idade - Te digo quantos anos vc tem
genero - Sera que e menino ou menina
completar - Faço lero lero a partir de uma frase
dadjoke - Dor
portal - Uma ratazana e um desejo
escolha - Deixa o bot escolher pra vc
nada - nada kkkk
addhoje - Adicionar ao hoje
addcheiro - Adicionar cheiro
tavivo - Manda um ping de teste com data
stop- Safe switch do mekhy
contato - Usa esse comando nunca te pedi nada
comandos - Lista os comandos do bot
configurar - Configura o bot
ruby - ruby
allen - allen
aly - aly
bobfirrer - bobfirrer
cloretodeodio - cloretodeodio
deltasnep - deltasnep
doctordirewolf - doctordirewolf
dr4g40 - dr4g40
fcking1212 - fcking1212
gummypuh - gummypuh
haura - haura
juuj - juuj
kuark - kuark
loganartic - loganartic
lukit - lukit
matt - matt
mekhy - mekhy
momo - momo
mousse - mousse
mrnatmax - mrnatmax
naja - naja
nicolas - nicolas
nizmot - nizmot
purplegalaxy - purplegalaxy
ralph - ralph
ratenhas - ratenhas
seive - seive
sopero - sopero
tomecow - tomecow
tonnyrussel - tonnyrussel
yoshiro - yoshiro

PASSIVAS:
Admins Granulares - O bot pode ser definido para apenas algumas pessoas poderem mexer nele. Fale com o Mekhy para implementar isso no seu chat
IA de conversa - Responde mensagens
IA assistente - Matemática, vocabulário, física, química, weather, etc
IA customizada - Respostas automáticas para palavras-chave predefinidas
stickers - Responde um sticker com outro sticker
captcha - Impede que bots mandem mensagens e kicka eles se não provarem que são humanos
limbo de imagem - Impede que novos membros mandem fotos, por um intervalo
sticker antispam - Impede raids ou longas cadeias de stickers em sequencia
speech to text - Transcripta mensagens de voz
identificador de musica - 6 ou mais palavras, ele manda uma musica correspondente se houver
location to address - Manda o endereço correspondente a um location
image upscaler - Amplia imagens de baixa resolução com inteligência artificial
Mensagem customizada de boas vindas


Fale com o Mekhy para adicionar um comando seu ou ensinar algo ao bot!